28 21 21 21 21 21 21 21 30 30 31 28 30 30 30 30 30 30 30 30 30 31 28 30 30 30 30 30 30 30 30 30 31 28 30 30 30 30 30 30 30 30 30 31 28 30 30 30 30 30 30 30 30 30 31 28 30 30 30 30 30 30 30 30 30 31 
36 0 0 0 0 0 0 0 0 0 36 36 0 0 0 0 0 0 0 0 0 36 36 0 0 0 0 0 0 0 0 0 36 36 0 0 0 0 0 0 0 0 0 36 36 0 0 0 0 0 0 0 0 0 36 36 0 0 0 0 0 0 0 0 0 36 
36 0 0 0 0 0 0 0 0 0 36 36 0 0 0 0 0 0 0 0 0 36 36 0 0 0 0 0 0 0 0 0 36 36 0 0 0 0 0 0 0 0 0 36 36 0 0 0 0 0 0 0 0 0 36 36 0 0 0 0 0 0 0 0 0 36 
36 0 0 0 0 0 0 0 0 0 36 36 0 0 0 0 0 0 0 0 0 36 36 0 0 0 0 0 0 0 0 0 36 36 0 0 0 0 0 0 0 0 0 36 36 0 0 0 0 0 0 0 0 0 36 36 0 0 0 0 0 0 0 0 0 36 
36 0 0 0 0 0 0 0 0 0 36 36 0 0 0 0 0 0 0 0 0 36 36 0 0 0 0 0 0 0 0 0 36 36 0 0 0 0 0 0 0 0 0 36 36 0 0 0 0 0 0 0 0 0 36 36 0 0 0 0 0 0 0 0 0 36 
36 0 0 0 0 0 0 0 0 0 36 36 0 0 0 0 0 0 0 0 0 36 36 0 0 0 0 0 0 0 0 0 36 36 0 0 0 0 0 0 0 0 0 36 36 0 0 0 0 0 0 0 0 0 36 36 0 0 0 0 0 0 0 0 0 36 
36 0 0 0 0 0 0 0 0 0 36 36 0 0 0 0 0 0 0 0 0 36 36 0 0 0 0 0 0 0 0 0 36 36 0 0 0 0 0 0 0 0 0 36 36 0 0 0 0 0 0 0 0 0 36 36 0 0 0 0 0 0 0 0 0 36 
36 0 0 0 0 0 0 0 0 0 36 36 0 0 0 0 0 0 0 0 0 36 36 0 0 0 0 0 0 0 0 0 36 36 0 0 0 0 0 0 0 0 0 36 36 0 0 0 0 0 0 0 0 0 36 36 0 0 0 0 0 0 0 0 0 36 
36 0 0 0 0 0 0 0 0 0 36 36 0 0 0 0 0 0 0 0 0 36 36 0 0 0 0 0 0 0 0 0 36 36 0 0 0 0 0 0 0 0 0 36 36 0 0 0 0 0 0 0 0 0 36 36 0 0 0 0 0 0 0 0 0 36 
36 0 0 0 0 0 0 0 0 0 36 36 0 0 0 0 0 0 0 0 0 36 36 0 0 0 0 0 0 0 0 0 36 36 0 0 0 0 0 0 0 0 0 36 36 0 0 0 0 0 0 0 0 0 36 36 0 0 0 0 0 0 0 0 0 36 
40 30 30 30 30 30 30 30 30 30 43 40 30 30 30 30 30 30 30 30 30 43 40 30 30 30 30 30 30 30 30 30 43 40 30 30 30 30 30 30 30 30 30 43 40 30 30 30 30 30 30 30 30 30 43 40 30 30 30 30 30 30 30 30 30 43 
28 30 30 30 30 30 30 30 30 30 31 28 30 30 30 30 30 30 30 30 30 31 28 30 30 30 30 30 30 30 30 30 31 28 30 30 30 30 30 30 30 30 30 31 28 30 30 30 30 30 30 30 30 30 31 28 30 30 30 30 30 30 30 30 30 31 
36 0 0 0 0 0 0 0 0 0 36 36 0 0 0 0 0 0 0 0 0 36 36 0 0 0 0 0 0 0 0 0 36 36 0 0 0 0 0 0 0 0 0 36 36 0 0 0 0 0 0 0 0 0 36 36 0 0 0 0 0 0 0 0 0 36 
36 0 0 0 0 0 0 0 0 0 36 36 0 0 0 0 0 0 0 0 0 36 36 0 0 28 30 30 30 31 0 0 36 36 0 0 0 0 0 0 0 0 0 36 36 0 0 0 0 0 0 0 0 0 36 36 0 0 0 0 0 0 0 0 0 36 
36 0 0 0 0 0 0 0 0 0 36 36 0 0 0 0 0 0 0 0 0 36 36 0 0 36 0 0 0 36 0 0 36 36 0 0 0 0 0 0 0 0 0 36 36 0 0 0 0 0 0 0 0 0 36 36 0 0 0 0 0 0 0 0 0 36 
36 0 0 0 0 0 0 0 0 0 36 36 0 0 0 0 0 0 0 0 0 36 36 0 0 36 0 0 0 36 0 0 36 36 0 0 0 0 0 0 0 0 0 36 36 0 0 0 0 0 0 0 0 0 36 36 0 0 0 0 0 0 0 0 0 36 
36 0 0 0 0 0 0 0 0 0 36 36 0 0 0 0 0 0 0 0 0 36 36 0 0 36 0 0 0 36 23 0 36 36 0 0 0 0 0 0 0 0 0 36 36 0 0 0 0 0 0 0 0 0 36 36 0 0 0 0 0 0 0 0 0 36 
36 0 0 0 0 0 0 0 0 0 36 36 0 0 0 0 0 0 0 0 0 36 36 0 0 42 0 0 0 42 0 0 36 36 0 0 0 0 0 0 0 0 0 36 36 0 0 0 0 0 0 0 0 0 36 36 0 0 0 0 0 0 0 0 0 36 
36 0 0 0 0 0 0 0 0 0 36 36 0 0 0 0 0 0 0 0 0 36 36 0 44 0 0 0 0 0 44 0 36 36 0 0 0 0 0 0 0 0 0 36 36 0 0 0 0 0 0 0 0 0 36 36 0 0 0 0 0 0 0 0 0 36 
36 0 0 0 0 0 0 0 0 0 36 36 0 0 0 0 0 0 0 0 0 36 36 44 44 0 0 0 0 0 44 0 36 36 0 0 0 0 0 0 0 0 0 36 36 0 0 0 0 0 0 0 0 0 36 36 0 0 0 0 0 0 0 0 0 36 
36 0 0 0 0 0 0 0 0 0 36 36 0 0 0 0 0 0 0 0 0 36 36 0 0 0 37 0 37 0 0 0 36 36 0 0 0 0 0 0 0 0 0 36 36 0 0 0 0 0 0 0 0 0 36 36 0 0 0 0 0 0 0 0 0 36 
40 30 30 30 30 30 30 30 30 30 43 40 30 30 30 30 30 30 30 30 30 43 40 30 30 30 43 44 40 30 30 30 43 40 30 30 30 30 30 30 30 30 30 43 40 30 30 30 30 30 30 30 30 30 43 40 30 30 30 30 30 30 30 30 30 43 
28 30 30 30 30 30 30 30 30 30 31 28 30 30 30 30 30 30 30 30 30 31 28 30 26 30 33 0 34 30 30 30 31 28 30 30 30 30 30 30 30 30 30 31 28 30 30 30 30 30 30 30 30 30 31 28 30 30 30 30 30 30 30 30 30 31 
36 0 0 0 0 0 0 0 0 0 36 36 0 0 0 0 0 0 0 0 0 36 36 8 4 0 5 6 7 10 0 0 36 36 0 0 0 0 0 0 0 0 0 36 36 0 0 0 0 0 0 0 0 0 36 36 0 0 0 0 0 0 0 0 0 36 
36 0 0 0 0 0 0 0 0 0 36 36 0 0 0 0 0 0 0 0 0 36 32 30 24 0 25 31 9 0 0 23 36 36 0 0 0 0 0 0 0 0 0 36 36 0 0 0 0 0 0 0 0 0 36 36 0 0 0 0 0 0 0 0 0 36 
36 0 0 0 0 0 0 0 0 0 36 36 0 0 0 0 0 0 0 0 0 36 36 0 0 0 0 39 8 0 7 23 39 36 0 0 0 0 0 0 0 0 0 36 36 0 0 0 0 0 0 0 0 0 36 36 0 0 0 0 0 0 0 0 0 36 
36 0 0 0 0 0 0 0 0 0 36 36 0 0 0 0 0 0 0 0 0 36 39 0 0 0 0 36 9 9 6 23 36 36 0 0 0 0 0 0 0 0 0 36 36 0 0 0 0 0 0 0 0 0 36 36 0 0 0 0 0 0 0 0 0 36 
36 0 0 0 0 0 0 0 0 0 36 36 0 0 0 0 0 0 0 0 0 36 32 30 30 26 30 41 38 24 0 25 35 36 0 0 0 0 0 0 0 0 0 36 36 0 0 0 0 0 0 0 0 0 36 36 0 0 0 0 0 0 0 0 0 36 
36 0 0 0 0 0 0 0 0 0 36 36 0 0 0 0 0 0 0 0 0 36 36 0 12 13 14 0 36 4 0 8 39 36 0 0 0 0 0 0 0 0 0 36 36 0 0 0 0 0 0 0 0 0 36 36 0 0 0 0 0 0 0 0 0 36 
36 0 0 0 0 0 0 0 0 0 36 36 0 0 0 0 0 0 0 0 0 36 39 0 20 15 22 0 42 4 0 8 36 36 0 0 0 0 0 0 0 0 0 36 36 0 0 0 0 0 0 0 0 0 36 36 0 0 0 0 0 0 0 0 0 36 
36 0 0 0 0 0 0 0 0 0 36 36 0 0 0 0 0 0 0 0 0 36 36 5 44 5 44 0 23 0 4 0 39 36 0 0 0 0 0 0 0 0 0 36 36 0 0 0 0 0 0 0 0 0 36 36 0 0 0 0 0 0 0 0 0 36 
36 0 0 0 0 0 0 0 0 0 36 36 0 0 0 0 0 0 0 0 0 36 36 9 10 0 0 0 23 0 0 0 36 36 0 0 0 0 0 0 0 0 0 36 36 0 0 0 0 0 0 0 0 0 36 36 0 0 0 0 0 0 0 0 0 36 
40 30 30 30 30 30 30 33 0 34 43 40 30 30 30 30 30 30 30 30 30 43 40 30 33 44 34 26 30 26 30 27 43 40 30 30 30 30 30 30 30 30 30 43 40 30 30 30 30 30 30 30 30 30 43 40 30 30 30 30 30 30 30 30 30 43 
28 30 30 30 30 30 30 33 44 34 31 28 30 30 30 30 30 38 30 30 30 31 28 30 33 0 28 30 30 30 30 30 31 28 30 30 30 38 30 30 30 30 30 31 28 30 30 30 30 30 30 30 30 30 31 28 30 30 30 30 30 30 30 30 30 31 
36 23 0 0 0 0 23 0 0 0 42 42 0 0 0 0 0 36 0 0 0 42 42 0 44 0 36 0 0 23 0 0 36 36 0 0 0 36 0 0 0 0 0 36 36 0 0 0 0 0 0 0 0 0 36 36 0 0 0 0 0 0 0 0 0 36 
32 30 31 0 23 23 0 0 0 0 0 0 0 0 0 0 0 36 0 0 0 0 44 0 0 0 36 0 0 0 0 0 36 36 0 0 0 36 0 0 0 0 0 36 36 0 0 0 0 0 0 0 0 0 36 36 0 0 0 0 0 0 0 0 0 36 
36 0 36 23 0 0 0 0 0 0 37 37 23 0 23 23 23 32 33 0 0 37 37 0 44 34 29 24 0 25 30 30 43 40 24 0 25 43 0 0 0 0 0 36 36 0 0 0 0 0 0 0 0 0 36 36 0 0 0 0 0 0 0 0 0 36 
36 0 36 0 0 0 0 0 0 0 36 36 0 23 0 0 0 36 0 0 0 36 36 0 0 0 36 0 0 0 0 0 0 0 0 23 44 0 0 0 0 0 0 36 36 0 0 0 0 0 0 0 0 0 36 36 0 0 0 0 0 0 0 0 0 36 
36 0 32 30 30 0 0 0 0 30 35 36 0 0 0 0 0 36 0 0 0 36 32 30 38 30 41 30 30 30 30 30 31 37 0 37 0 0 0 0 0 0 0 36 36 0 0 0 0 0 0 0 0 0 36 36 0 0 0 0 0 0 0 0 0 36 
36 0 36 0 0 44 0 0 0 0 36 36 0 0 0 0 0 36 23 0 0 36 36 0 36 44 0 0 0 44 0 44 42 42 0 36 0 0 0 0 0 0 0 36 36 0 0 0 0 0 0 0 0 0 36 36 0 0 0 0 0 0 0 0 0 36 
36 44 36 0 0 44 0 0 0 0 36 36 0 0 0 0 0 36 23 0 0 36 36 44 42 0 0 44 0 0 44 0 0 0 0 36 0 0 0 0 0 0 0 36 36 0 0 0 0 0 0 0 0 0 36 36 0 0 0 0 0 0 0 0 0 36 
36 0 40 30 30 30 30 30 30 30 43 40 30 30 24 0 25 41 0 0 0 43 42 0 0 44 0 0 44 0 0 0 37 37 44 42 0 0 0 0 0 0 0 36 36 0 0 0 0 0 0 0 0 0 36 36 0 0 0 0 0 0 0 0 0 36 
36 0 0 0 0 0 0 0 0 0 0 0 0 0 0 0 0 0 0 0 0 0 0 0 0 0 0 44 0 0 44 0 36 36 0 0 0 0 0 0 0 0 0 36 36 0 0 0 0 0 0 0 0 0 36 36 0 0 0 0 0 0 0 0 0 36 
40 33 44 34 30 30 30 30 30 30 33 34 30 30 30 30 30 30 30 30 30 33 34 30 30 30 30 30 30 30 30 30 43 40 30 30 30 30 30 30 30 30 30 43 40 30 30 30 30 30 30 30 30 30 43 40 30 30 30 30 30 30 30 30 30 43 
28 33 0 34 30 30 30 30 30 30 31 28 30 30 30 30 30 30 30 30 30 31 28 30 30 30 30 30 30 30 30 30 31 28 30 30 30 30 30 30 30 30 30 31 28 30 30 38 30 30 30 30 30 30 31 28 30 30 30 30 38 30 30 30 30 31 
36 0 0 0 0 0 0 0 0 0 36 36 0 0 0 0 0 0 0 0 0 36 36 0 0 0 0 0 0 0 0 0 36 36 0 0 0 0 0 0 0 0 0 36 36 0 0 36 23 12 13 13 14 23 36 36 0 0 0 23 36 0 0 0 23 36 
32 30 30 30 30 30 38 24 0 25 35 36 0 0 0 0 0 0 0 0 0 36 36 0 0 0 0 0 0 0 0 0 36 36 0 0 0 0 0 0 0 0 0 36 36 0 23 36 23 20 15 15 22 23 36 36 0 0 0 23 36 0 34 38 30 35 
36 0 0 0 0 0 36 0 0 0 36 36 0 0 0 0 0 0 0 0 0 36 36 0 0 0 0 0 0 0 0 0 36 36 0 0 0 0 0 0 0 0 0 36 36 0 23 36 0 0 0 0 0 0 36 36 0 0 0 0 36 0 0 36 0 36 
36 0 0 0 0 0 36 0 0 0 36 36 0 0 0 0 0 0 0 0 0 36 36 0 0 0 0 0 0 0 0 0 36 36 0 0 0 0 0 0 0 0 0 36 36 0 0 36 44 44 0 0 44 44 36 36 0 0 0 0 40 31 0 36 0 36 
36 0 0 0 0 0 40 30 30 30 35 36 0 0 0 0 0 0 0 0 0 36 36 0 0 0 0 0 0 0 0 0 36 36 0 0 0 0 0 0 0 0 0 36 36 0 0 36 0 0 0 0 0 0 36 36 0 0 0 0 0 36 0 36 0 36 
36 0 0 0 0 0 0 0 0 0 36 36 0 0 0 0 0 0 0 0 0 36 36 0 0 0 0 0 0 0 0 0 36 36 0 0 0 0 0 0 0 0 0 36 36 0 0 40 30 24 0 25 30 30 35 36 0 0 0 0 0 36 0 24 0 25 
36 0 0 0 0 0 0 0 0 0 36 36 0 0 0 0 0 0 0 0 0 36 36 0 0 0 0 0 0 0 0 0 36 36 0 0 0 0 0 0 0 0 0 36 36 0 0 44 0 0 0 0 0 0 36 36 0 0 0 0 0 42 0 0 0 36 
36 0 0 0 0 0 0 0 0 0 36 36 0 0 0 0 0 0 0 0 0 36 36 0 0 0 0 0 0 0 0 0 36 36 0 0 0 0 0 0 0 0 0 36 36 0 0 37 0 0 0 0 0 0 36 36 23 0 0 0 0 0 0 0 0 36 
36 0 0 0 0 0 0 0 0 0 36 36 0 0 0 0 0 0 0 0 0 36 36 0 0 0 0 0 0 0 0 0 36 36 0 0 0 0 0 0 0 0 0 36 36 0 0 39 0 0 44 44 0 0 36 36 0 23 0 0 0 0 0 0 0 36 
40 30 30 30 30 30 30 30 30 30 43 40 30 30 30 30 30 30 30 30 30 43 40 30 30 30 30 30 30 30 30 30 43 40 30 30 30 30 30 30 30 30 30 43 40 30 30 41 30 30 30 30 30 30 43 40 30 30 30 30 30 30 30 30 30 41 
